{
    "name": "pastel-fields/path-1",
    "levels": [{
        "height": -32
    }, {
        "height": 0
    }, {
        "height": 64
    }],
    "mapWidth": 25,
    "mapHeight": 25,
    "masterLevel": 1,
    "attributes": {
        "saveMode": "",
        "bgm": "autumnsFall",
        "cameraInBounds": true,
        "map-sounds": "LIGHT_WIND",
        "mapStyle": "",
        "weather": "AUTUMN_RAIN_WEAK",
        "npcRunners": "REGULAR",
        "area": "pastel-fields"
    },
    "screen": {
        "x": 0,
        "y": 0
    },
    "entities": [{
        "type": "TeleportGround",
        "x": 0,
        "y": 224,
        "level": 1,
        "settings": {
            "mapId": 2,
            "size": {
                "x": 32,
                "y": 64
            },
            "map": "pastel-fields.west",
            "marker": "path-1",
            "name": "west",
            "dir": "WEST",
            "npcRunnerProb": 1,
            "zHeight": 32
        }
    }],
    "layer": [{
        "type": "Background",
        "name": "ground",
        "level": 1,
        "width": 25,
        "height": 25,
        "visible": 1,
        "tilesetName": "media/map/twilight-outside.png",
        "repeat": false,
        "distance": 1,
        "tilesize": 16,
        "moveSpeed": {
            "x": 0,
            "y": 0
        },
        "data": [
            [0, 0, 0, 0, 0, 0, 0, 0, 0, 0, 0, 0, 0, 0, 0, 0, 0, 0, 0, 0, 0, 0, 0, 0, 0],
            [0, 0, 0, 0, 0, 0, 0, 0, 0, 0, 0, 0, 0, 0, 0, 0, 0, 0, 0, 0, 0, 0, 0, 0, 0],
            [0, 0, 0, 0, 0, 0, 0, 0, 0, 0, 0, 0, 0, 0, 0, 0, 0, 0, 0, 0, 0, 0, 0, 0, 0],
            [0, 0, 0, 0, 0, 0, 0, 0, 0, 0, 0, 0, 0, 0, 0, 0, 0, 0, 0, 0, 0, 0, 0, 0, 0],
            [257, 291, 292, 291, 292, 291, 292, 291, 292, 291, 291, 292, 291, 291, 291, 291, 292, 291, 291, 291, 291, 291, 292, 291, 262],
            [257, 291, 292, 291, 292, 291, 292, 291, 292, 291, 291, 292, 291, 291, 291, 291, 292, 291, 291, 291, 291, 291, 292, 291, 262],
            [257, 291, 291, 292, 292, 291, 291, 292, 291, 291, 292, 291, 291, 291, 292, 291, 291, 292, 291, 291, 291, 291, 291, 292, 262],
            [289, 323, 324, 323, 324, 323, 324, 323, 324, 323, 324, 323, 324, 323, 324, 323, 323, 324, 323, 323, 323, 323, 323, 324, 294],
            [1, 1, 1, 1, 1, 1, 1, 1, 1, 1, 1, 1, 1, 1, 1, 1, 1, 1, 1, 1, 1, 1, 1, 1, 1],
            [1, 1, 1, 1, 1, 1, 1, 1, 1, 1, 1, 1, 1, 1, 1, 1, 1, 1, 1, 1, 1, 1, 1, 1, 1],
            [1, 1, 1, 1, 1, 1, 1, 1, 1, 1, 1, 1, 1, 1, 1, 1, 1, 1, 1, 1, 1, 1, 1, 1, 1],
            [1, 1, 1, 33, 1, 1, 1, 1, 1, 1, 1, 33, 1, 1, 33, 33, 33, 33, 33, 1, 1, 33, 33, 1, 1],
            [1, 1, 1, 33, 1, 1, 1, 1, 33, 1, 1, 33, 1, 1, 1, 1, 33, 1, 1, 1, 1, 33, 1, 33, 1],
            [1, 1, 1, 33, 33, 1, 1, 1, 33, 1, 1, 33, 1, 1, 1, 1, 33, 1, 1, 1, 1, 33, 1, 33, 1],
            [1, 1, 1, 1, 33, 1, 1, 33, 33, 1, 1, 33, 1, 1, 1, 1, 33, 1, 1, 1, 33, 33, 1, 33, 1],
            [1, 1, 1, 1, 33, 1, 1, 33, 1, 33, 33, 33, 1, 1, 1, 1, 33, 1, 1, 1, 33, 1, 1, 33, 1],
            [1, 1, 1, 1, 1, 33, 1, 33, 1, 33, 33, 1, 1, 1, 1, 1, 33, 1, 1, 1, 33, 33, 33, 1, 1],
            [1, 1, 1, 1, 1, 33, 33, 33, 1, 33, 33, 1, 1, 1, 33, 33, 33, 1, 1, 1, 33, 1, 1, 1, 1],
            [1, 1, 1, 1, 1, 33, 33, 1, 1, 33, 33, 1, 1, 1, 1, 1, 33, 33, 1, 1, 33, 1, 1, 1, 1],
            [1, 1, 1, 1, 1, 1, 33, 1, 1, 1, 1, 1, 1, 1, 1, 1, 1, 1, 1, 1, 33, 1, 1, 1, 1],
            [1, 1, 1, 1, 1, 1, 1, 1, 1, 1, 1, 1, 1, 1, 1, 1, 1, 1, 1, 1, 33, 1, 1, 1, 1],
            [1, 1, 1, 1, 1, 1, 1, 1, 1, 1, 1, 33, 1, 1, 33, 1, 1, 1, 1, 1, 33, 1, 1, 1, 1],
            [1, 1, 1, 1, 1, 1, 1, 1, 1, 1, 1, 1, 1, 1, 1, 1, 1, 1, 1, 1, 1, 1, 1, 1, 1],
            [1, 1, 1, 1, 1, 1, 1, 1, 1, 1, 1, 33, 1, 1, 33, 1, 1, 1, 1, 1, 1, 1, 1, 1, 1],
            [1, 1, 1, 1, 1, 1, 1, 1, 1, 1, 1, 33, 33, 33, 33, 1, 1, 1, 1, 1, 1, 1, 1, 1, 1]
        ]
    }, {
        "type": "Collision",
        "name": "coll",
        "level": 1,
        "width": 25,
        "height": 25,
        "visible": 1,
        "tilesetName": "media/map/collisiontiles-16x16.png",
        "repeat": false,
        "distance": 1,
        "tilesize": 16,
        "moveSpeed": {
            "x": 0,
            "y": 0
        },
        "data": [
            [2, 2, 2, 2, 2, 2, 2, 2, 2, 2, 2, 2, 2, 2, 2, 2, 2, 2, 2, 2, 2, 2, 2, 2, 2],
            [2, 2, 2, 2, 2, 2, 2, 2, 2, 2, 2, 2, 2, 2, 2, 2, 2, 2, 2, 2, 2, 2, 2, 2, 2],
            [2, 2, 2, 2, 2, 2, 2, 2, 2, 2, 2, 2, 2, 2, 2, 2, 2, 2, 2, 2, 2, 2, 2, 2, 2],
            [2, 2, 2, 2, 2, 2, 2, 2, 2, 2, 2, 2, 2, 2, 2, 2, 2, 2, 2, 2, 2, 2, 2, 2, 2],
            [2, 2, 2, 2, 2, 2, 2, 2, 2, 2, 2, 2, 2, 2, 2, 2, 2, 2, 2, 2, 2, 2, 2, 2, 2],
            [2, 2, 2, 2, 2, 2, 2, 2, 2, 2, 2, 2, 2, 2, 2, 2, 2, 2, 2, 2, 2, 2, 2, 2, 2],
            [2, 2, 2, 2, 2, 2, 2, 2, 2, 2, 2, 2, 2, 2, 2, 2, 2, 2, 2, 2, 2, 2, 2, 2, 2],
            [10, 2, 2, 2, 2, 2, 2, 2, 2, 2, 2, 2, 2, 2, 2, 2, 2, 2, 2, 2, 2, 2, 2, 2, 9],
            [0, 0, 0, 0, 0, 0, 0, 0, 0, 0, 0, 0, 0, 0, 0, 0, 0, 0, 0, 0, 0, 0, 0, 0, 0],
            [0, 0, 0, 0, 0, 0, 0, 0, 0, 0, 0, 0, 0, 0, 0, 0, 0, 0, 0, 0, 0, 0, 0, 0, 0],
            [0, 0, 0, 0, 0, 0, 0, 0, 0, 0, 0, 0, 0, 0, 0, 0, 0, 0, 0, 0, 0, 0, 0, 0, 0],
            [0, 0, 0, 0, 0, 0, 0, 0, 0, 0, 0, 0, 0, 0, 0, 0, 0, 0, 0, 0, 0, 0, 0, 0, 0],
            [0, 0, 0, 0, 0, 0, 0, 0, 0, 0, 0, 0, 0, 0, 0, 0, 0, 0, 0, 0, 0, 0, 0, 0, 0],
            [0, 0, 0, 0, 0, 0, 0, 0, 0, 0, 0, 0, 0, 0, 0, 0, 0, 0, 0, 0, 0, 0, 0, 0, 0],
            [0, 0, 0, 0, 0, 0, 0, 0, 0, 0, 0, 0, 0, 0, 0, 0, 0, 0, 0, 0, 0, 0, 0, 0, 0],
            [0, 0, 0, 0, 0, 0, 0, 0, 0, 0, 0, 0, 0, 0, 0, 0, 0, 0, 0, 0, 0, 0, 0, 0, 0],
            [0, 0, 0, 0, 0, 0, 0, 0, 0, 0, 0, 0, 0, 0, 0, 0, 0, 0, 0, 0, 0, 0, 0, 0, 0],
            [0, 0, 0, 0, 0, 0, 0, 0, 0, 0, 0, 0, 0, 0, 0, 0, 0, 0, 0, 0, 0, 0, 0, 0, 0],
            [0, 0, 0, 0, 0, 0, 0, 0, 0, 0, 0, 0, 0, 0, 0, 0, 0, 0, 0, 0, 0, 0, 0, 0, 0],
            [0, 0, 0, 0, 0, 0, 0, 0, 0, 0, 0, 0, 0, 0, 0, 0, 0, 0, 0, 0, 0, 0, 0, 0, 0],
            [0, 0, 0, 0, 0, 0, 0, 0, 0, 0, 0, 0, 0, 0, 0, 0, 0, 0, 0, 0, 0, 0, 0, 0, 0],
            [0, 0, 0, 0, 0, 0, 0, 0, 0, 0, 0, 0, 0, 0, 0, 0, 0, 0, 0, 0, 0, 0, 0, 0, 0],
            [0, 0, 0, 0, 0, 0, 0, 0, 0, 0, 0, 0, 0, 0, 0, 0, 0, 0, 0, 0, 0, 0, 0, 0, 0],
            [0, 0, 0, 0, 0, 0, 0, 0, 0, 0, 0, 0, 0, 0, 0, 0, 0, 0, 0, 0, 0, 0, 0, 0, 0],
            [0, 0, 0, 0, 0, 0, 0, 0, 0, 0, 0, 0, 0, 0, 0, 0, 0, 0, 0, 0, 0, 0, 0, 0, 0]
        ]
    }, {
        "type": "Background",
        "name": "up",
        "level": 2,
        "width": 25,
        "height": 25,
        "visible": 1,
        "tilesetName": "media/map/twilight-outside.png",
        "repeat": false,
        "distance": 1,
        "tilesize": 16,
        "moveSpeed": {
            "x": 0,
            "y": 0
        },
        "data": [
            [195, 1, 1, 1, 1, 1, 1, 1, 1, 1, 1, 1, 1, 1, 1, 1, 1, 1, 1, 1, 1, 1, 1, 1, 196],
            [227, 1, 1, 1, 1, 1, 1, 1, 1, 1, 1, 1, 1, 1, 1, 1, 1, 1, 1, 1, 1, 1, 1, 1, 228],
            [227, 1, 1, 1, 1, 1, 1, 1, 1, 1, 1, 1, 1, 1, 1, 1, 1, 1, 1, 1, 1, 1, 1, 1, 228],
            [225, 259, 260, 259, 260, 259, 260, 259, 260, 259, 260, 259, 260, 259, 260, 260, 259, 260, 259, 260, 259, 260, 259, 260, 230],
            [0, 0, 0, 0, 0, 0, 0, 0, 0, 0, 0, 0, 0, 0, 0, 0, 0, 0, 0, 0, 0, 0, 0, 0, 0],
            [0, 0, 0, 0, 0, 0, 0, 0, 0, 0, 0, 0, 0, 0, 0, 0, 0, 0, 0, 0, 0, 0, 0, 0, 0],
            [0, 0, 0, 0, 0, 0, 0, 0, 0, 0, 0, 0, 0, 0, 0, 0, 0, 0, 0, 0, 0, 0, 0, 0, 0],
            [0, 0, 0, 0, 0, 0, 0, 0, 0, 0, 0, 0, 0, 0, 0, 0, 0, 0, 0, 0, 0, 0, 0, 0, 0],
            [0, 0, 0, 0, 0, 0, 0, 0, 0, 0, 0, 0, 0, 0, 0, 0, 0, 0, 0, 0, 0, 0, 0, 0, 0],
            [0, 0, 0, 0, 0, 0, 0, 0, 0, 0, 0, 0, 0, 0, 0, 0, 0, 0, 0, 0, 0, 0, 0, 0, 0],
            [0, 0, 0, 0, 0, 0, 0, 0, 0, 0, 0, 0, 0, 0, 0, 0, 0, 0, 0, 0, 0, 0, 0, 0, 0],
            [0, 0, 0, 0, 0, 0, 0, 0, 0, 0, 0, 0, 0, 0, 0, 0, 0, 0, 0, 0, 0, 0, 0, 0, 0],
            [0, 0, 0, 0, 0, 0, 0, 0, 0, 0, 0, 0, 0, 0, 0, 0, 0, 0, 0, 0, 0, 0, 0, 0, 0],
            [0, 0, 0, 0, 0, 0, 0, 0, 0, 0, 0, 0, 0, 0, 0, 0, 0, 0, 0, 0, 0, 0, 0, 0, 0],
            [0, 0, 0, 0, 0, 0, 0, 0, 0, 0, 0, 0, 0, 0, 0, 0, 0, 0, 0, 0, 0, 0, 0, 0, 0],
            [0, 0, 0, 0, 0, 0, 0, 0, 0, 0, 0, 0, 0, 0, 0, 0, 0, 0, 0, 0, 0, 0, 0, 0, 0],
            [0, 0, 0, 0, 0, 0, 0, 0, 0, 0, 0, 0, 0, 0, 0, 0, 0, 0, 0, 0, 0, 0, 0, 0, 0],
            [0, 0, 0, 0, 0, 0, 0, 0, 0, 0, 0, 0, 0, 0, 0, 0, 0, 0, 0, 0, 0, 0, 0, 0, 0],
            [0, 0, 0, 0, 0, 0, 0, 0, 0, 0, 0, 0, 0, 0, 0, 0, 0, 0, 0, 0, 0, 0, 0, 0, 0],
            [0, 0, 0, 0, 0, 0, 0, 0, 0, 0, 0, 0, 0, 0, 0, 0, 0, 0, 0, 0, 0, 0, 0, 0, 0],
            [0, 0, 0, 0, 0, 0, 0, 0, 0, 0, 0, 0, 0, 0, 0, 0, 0, 0, 0, 0, 0, 0, 0, 0, 0],
            [0, 0, 0, 0, 0, 0, 0, 0, 0, 0, 0, 0, 0, 0, 0, 0, 0, 0, 0, 0, 0, 0, 0, 0, 0],
            [0, 0, 0, 0, 0, 0, 0, 0, 0, 0, 0, 0, 0, 0, 0, 0, 0, 0, 0, 0, 0, 0, 0, 0, 0],
            [0, 0, 0, 0, 0, 0, 0, 0, 0, 0, 0, 0, 0, 0, 0, 0, 0, 0, 0, 0, 0, 0, 0, 0, 0],
            [0, 0, 0, 0, 0, 0, 0, 0, 0, 0, 0, 0, 0, 0, 0, 0, 0, 0, 0, 0, 0, 0, 0, 0, 0]
        ]
    }]
}