{
    "name": "dev",
    "levels": [{
        "height": 0
    }, {
        "height": 32
    }],
    "mapWidth": 25,
    "mapHeight": 30,
    "masterLevel": 0,
    "attributes": {
        "saveMode": "DISABLED",
        "bgm": "crossCentral",
        "cameraInBounds": false,
        "map-sounds": "",
        "mapStyle": "",
        "weather": "NONE",
        "npcRunners": "",
        "area": "twilight-city"
    },
    "screen": {
        "x": 0,
        "y": 0
    },
    "entities": [{
        "type": "TeleportField",
        "x": 200,
        "y": 80,
        "level": 0,
        "settings": {
            "size": {
                "x": 16,
                "y": 16,
                "z": 0
            },
            "name": "dev",
            "dir": "SOUTH",
            "marker": "DevRoomExit",
            "teleportLabel": "Exit",
            "map": "twilight-city.library",
            "gfxType": "SOLID",
            "mapId": 2
        }
    }, {
        "type": "WaveWarp",
        "x": 40,
        "y": 288,
        "level": 0,
        "settings": {
            "mapId": 3,
            "name": "w1",
            "entity": {
                "global": true,
                "name": "w2"
            }
        }
    }, {
        "type": "WallHorizontal",
        "x": 16,
        "y": 336,
        "level": 0,
        "settings": {
            "mapId": 4,
            "size": {
                "x": 64,
                "y": 1
            },
            "leftEnd": "STOP",
            "rightEnd": "CONTINUE",
            "collType": "BLOCK",
            "wallZHeight": 32
        }
    }, {
        "type": "WaveWarp",
        "x": 40,
        "y": 344,
        "level": 0,
        "settings": {
            "mapId": 5,
            "name": "w2"
        }
    }, {
        "type": "WallHorizontal",
        "x": 16,
        "y": 400,
        "level": 0,
        "settings": {
            "mapId": 6,
            "size": {
                "x": 64,
                "y": 1
            },
            "leftEnd": "STOP",
            "rightEnd": "CONTINUE",
            "collType": "BLOCK",
            "wallZHeight": 32
        }
    }, {
        "type": "WallVertical",
        "x": 80,
        "y": 336,
        "level": 0,
        "settings": {
            "mapId": 7,
            "size": {
                "x": 1,
                "y": 64
            },
            "condition": "!tmp.down",
            "collType": "BLOCK",
            "topEnd": "CORNER_LEFT",
            "bottomEnd": "CORNER_LEFT",
            "wallZHeight": 32
        }
    }, {
        "type": "Switch",
        "x": 40,
        "y": 368,
        "level": 0,
        "settings": {
            "mapId": 9,
            "variable": "tmp.down"
        }
    }],
    "layer": [{
        "type": "Background",
        "name": "Ground",
        "level": 0,
        "width": 25,
        "height": 30,
        "visible": 1,
        "tilesetName": "media/map/lavender-interior.png",
        "repeat": false,
        "distance": 1,
        "tilesize": 16,
        "moveSpeed": {
            "x": 0,
            "y": 0
        },
        "data": [
            [0, 0, 0, 0, 0, 0, 0, 7, 10, 11, 11, 11, 11, 11, 11, 11, 11, 12, 9, 0, 0, 0, 0, 0, 0],
            [0, 0, 0, 0, 0, 0, 7, 10, 42, 43, 43, 43, 43, 43, 43, 43, 43, 44, 12, 9, 0, 0, 0, 0, 0],
            [0, 0, 0, 0, 0, 7, 10, 42, 74, 75, 75, 75, 75, 75, 75, 75, 75, 76, 44, 12, 9, 0, 0, 0, 0],
            [0, 0, 0, 0, 7, 10, 42, 74, 106, 107, 107, 107, 107, 107, 107, 107, 107, 108, 76, 44, 12, 9, 0, 0, 0],
            [0, 0, 0, 7, 10, 42, 74, 106, 138, 139, 139, 139, 139, 139, 139, 139, 139, 140, 108, 76, 44, 12, 9, 0, 0],
            [0, 0, 7, 10, 42, 74, 106, 138, 170, 1, 1, 1, 1, 1, 1, 1, 1, 172, 140, 108, 76, 44, 12, 9, 0],
            [0, 7, 10, 42, 74, 106, 138, 170, 1, 1, 1, 1, 1, 1, 1, 1, 1, 204, 172, 140, 108, 76, 44, 12, 9],
            [7, 10, 42, 74, 106, 138, 170, 1, 1, 1, 1, 1, 1, 1, 1, 1, 1, 1, 204, 172, 140, 108, 76, 44, 264],
            [10, 42, 74, 106, 138, 170, 1, 1, 1, 1, 1, 1, 1, 1, 1, 1, 1, 1, 1, 204, 172, 140, 108, 76, 264],
            [264, 74, 106, 138, 170, 1, 1, 1, 1, 1, 1, 1, 1, 1, 1, 1, 1, 1, 1, 1, 204, 172, 140, 108, 264],
            [264, 106, 138, 170, 1, 1, 1, 1, 1, 1, 1, 1, 1, 1, 1, 1, 1, 1, 1, 1, 1, 204, 172, 140, 264],
            [264, 138, 170, 1, 1, 1, 1, 1, 1, 1, 1, 1, 1, 1, 1, 1, 1, 1, 1, 1, 1, 1, 204, 172, 264],
            [264, 170, 1, 1, 1, 1, 1, 1, 1, 1, 1, 1, 1, 1, 1, 1, 1, 1, 1, 1, 1, 1, 1, 204, 264],
            [264, 1, 1, 1, 1, 1, 1, 1, 1, 1, 1, 1, 1, 1, 1, 1, 1, 1, 1, 1, 1, 1, 1, 1, 264],
            [264, 1, 1, 1, 1, 1, 1, 1, 1, 1, 1, 1, 1, 1, 1, 1, 1, 1, 1, 1, 1, 1, 1, 1, 264],
            [264, 1, 1, 1, 1, 1, 1, 1, 1, 1, 1, 1, 1, 1, 1, 1, 1, 1, 1, 1, 1, 1, 1, 1, 264],
            [264, 388, 388, 388, 388, 1, 1, 1, 1, 1, 1, 1, 1, 1, 1, 1, 1, 1, 1, 1, 1, 1, 1, 1, 264],
            [264, 388, 388, 388, 388, 1, 1, 1, 1, 1, 1, 1, 1, 1, 1, 1, 1, 1, 1, 1, 1, 1, 1, 1, 264],
            [264, 388, 388, 388, 388, 1, 1, 1, 1, 1, 1, 1, 1, 1, 1, 1, 1, 1, 1, 1, 1, 1, 1, 1, 264],
            [264, 388, 388, 388, 388, 1, 1, 1, 1, 1, 1, 1, 1, 1, 1, 1, 1, 1, 1, 1, 1, 1, 1, 1, 264],
            [264, 388, 388, 388, 388, 1, 1, 1, 1, 1, 1, 1, 1, 1, 1, 1, 1, 1, 1, 1, 1, 1, 1, 1, 264],
            [264, 225, 226, 226, 227, 1, 1, 1, 1, 1, 1, 1, 1, 1, 1, 1, 1, 1, 1, 1, 1, 1, 1, 1, 264],
            [264, 257, 258, 258, 259, 1, 1, 1, 1, 1, 1, 1, 1, 1, 1, 1, 1, 1, 1, 1, 1, 1, 1, 1, 264],
            [264, 257, 258, 258, 259, 1, 1, 1, 1, 1, 1, 1, 1, 1, 1, 1, 1, 1, 1, 1, 1, 1, 1, 1, 264],
            [264, 289, 290, 290, 291, 1, 1, 1, 1, 1, 1, 1, 1, 1, 1, 1, 1, 1, 1, 1, 1, 1, 1, 1, 264],
            [264, 1, 1, 1, 1, 1, 1, 1, 1, 1, 1, 1, 1, 1, 1, 1, 1, 1, 1, 1, 1, 1, 1, 1, 264],
            [264, 1, 1, 1, 1, 1, 1, 1, 1, 1, 1, 1, 1, 1, 1, 1, 1, 1, 1, 1, 1, 1, 1, 1, 264],
            [264, 1, 1, 1, 1, 1, 1, 1, 1, 1, 1, 1, 1, 1, 1, 1, 1, 1, 1, 1, 1, 1, 1, 1, 264],
            [264, 1, 1, 1, 1, 1, 1, 1, 1, 1, 1, 1, 1, 1, 1, 1, 1, 1, 1, 1, 1, 1, 1, 1, 264],
            [264, 264, 264, 264, 264, 264, 264, 264, 264, 264, 264, 264, 264, 264, 264, 264, 264, 264, 264, 264, 264, 264, 264, 264, 264]
        ]
    }, {
        "type": "Collision",
        "name": "Coll",
        "level": 0,
        "width": 25,
        "height": 30,
        "visible": 1,
        "tilesetName": "media/map/collisiontiles-16x16.png",
        "repeat": false,
        "distance": 1,
        "tilesize": 16,
        "moveSpeed": {
            "x": 0,
            "y": 0
        },
        "data": [
            [0, 0, 0, 0, 2, 2, 2, 2, 2, 2, 2, 2, 2, 2, 2, 2, 2, 2, 2, 2, 2, 0, 0, 0, 0],
            [0, 0, 0, 0, 2, 2, 2, 2, 2, 2, 2, 2, 2, 2, 2, 2, 2, 2, 2, 2, 2, 0, 0, 0, 0],
            [0, 0, 0, 0, 2, 2, 2, 2, 2, 2, 2, 2, 2, 2, 2, 2, 2, 2, 2, 2, 2, 0, 0, 0, 0],
            [0, 0, 0, 0, 2, 2, 2, 2, 2, 2, 2, 2, 2, 2, 2, 2, 2, 2, 2, 2, 2, 0, 0, 0, 0],
            [0, 0, 0, 0, 2, 2, 2, 2, 2, 2, 2, 2, 2, 2, 2, 2, 2, 2, 2, 2, 2, 2, 0, 0, 0],
            [0, 0, 0, 0, 2, 2, 2, 2, 9, 0, 0, 0, 0, 0, 0, 0, 0, 10, 2, 2, 2, 2, 2, 0, 0],
            [0, 0, 0, 2, 2, 2, 2, 9, 0, 0, 0, 0, 0, 0, 0, 0, 0, 0, 10, 2, 2, 2, 2, 0, 0],
            [0, 0, 2, 2, 2, 2, 9, 0, 0, 0, 0, 0, 0, 0, 0, 0, 0, 0, 0, 10, 2, 2, 2, 2, 2],
            [0, 2, 2, 2, 2, 9, 0, 0, 0, 0, 0, 0, 0, 0, 0, 0, 0, 0, 0, 0, 10, 2, 2, 2, 2],
            [2, 2, 2, 2, 9, 0, 0, 0, 0, 0, 0, 0, 0, 0, 0, 0, 0, 0, 0, 0, 0, 10, 2, 2, 2],
            [2, 2, 2, 9, 0, 0, 0, 0, 0, 0, 0, 0, 0, 0, 0, 0, 0, 0, 0, 0, 0, 0, 10, 2, 2],
            [2, 2, 9, 0, 0, 0, 0, 0, 0, 0, 0, 0, 0, 0, 0, 0, 0, 0, 0, 0, 0, 0, 0, 10, 2],
            [2, 9, 0, 0, 0, 0, 0, 0, 0, 0, 0, 0, 0, 0, 0, 0, 0, 0, 0, 0, 0, 0, 0, 0, 2],
            [2, 0, 0, 0, 0, 0, 0, 0, 0, 0, 0, 0, 0, 0, 0, 0, 0, 0, 0, 0, 0, 0, 0, 0, 2],
            [2, 0, 0, 0, 0, 0, 0, 0, 0, 0, 0, 0, 0, 0, 0, 0, 0, 0, 0, 0, 0, 0, 0, 0, 2],
            [2, 0, 0, 0, 0, 0, 0, 0, 0, 0, 0, 0, 0, 0, 0, 0, 0, 0, 0, 0, 0, 0, 0, 0, 2],
            [2, 0, 0, 0, 0, 0, 0, 0, 0, 0, 0, 0, 0, 0, 0, 0, 0, 0, 0, 0, 0, 0, 0, 0, 2],
            [2, 0, 0, 0, 0, 0, 0, 0, 0, 0, 0, 0, 0, 0, 0, 0, 0, 0, 0, 0, 0, 0, 0, 0, 2],
            [2, 0, 0, 0, 0, 0, 0, 0, 0, 0, 0, 0, 0, 0, 0, 0, 0, 0, 0, 0, 0, 0, 0, 0, 2],
            [2, 0, 0, 0, 0, 0, 0, 0, 0, 0, 0, 0, 0, 0, 0, 0, 0, 0, 0, 0, 0, 0, 0, 0, 2],
            [2, 0, 0, 0, 0, 0, 0, 0, 0, 0, 0, 0, 0, 0, 0, 0, 0, 0, 0, 0, 0, 0, 0, 0, 2],
            [2, 0, 0, 0, 0, 0, 0, 0, 0, 0, 0, 0, 0, 0, 0, 0, 0, 0, 0, 0, 0, 0, 0, 0, 2],
            [2, 0, 0, 0, 0, 0, 0, 0, 0, 0, 0, 0, 0, 0, 0, 0, 0, 0, 0, 0, 0, 0, 0, 0, 2],
            [2, 0, 0, 0, 0, 0, 0, 0, 0, 0, 0, 0, 0, 0, 0, 0, 0, 0, 0, 0, 0, 0, 0, 0, 2],
            [2, 0, 0, 0, 0, 0, 0, 0, 0, 0, 0, 0, 0, 0, 0, 0, 0, 0, 0, 0, 0, 0, 0, 0, 2],
            [2, 0, 0, 0, 0, 0, 0, 0, 0, 0, 0, 0, 0, 0, 0, 0, 0, 0, 0, 0, 0, 0, 0, 0, 2],
            [2, 0, 0, 0, 0, 0, 0, 0, 0, 0, 0, 0, 0, 0, 0, 0, 0, 0, 0, 0, 0, 0, 0, 0, 2],
            [2, 0, 0, 0, 0, 0, 0, 0, 0, 0, 0, 0, 0, 0, 0, 0, 0, 0, 0, 0, 0, 0, 0, 0, 2],
            [2, 0, 0, 0, 0, 0, 0, 0, 0, 0, 0, 0, 0, 0, 0, 0, 0, 0, 0, 0, 0, 0, 0, 0, 2],
            [2, 2, 2, 2, 2, 2, 2, 2, 2, 2, 2, 2, 2, 2, 2, 2, 2, 2, 2, 2, 2, 2, 2, 2, 2]
        ]
    }]
}